13,13,,,,,,,,,,,
7,18,,,,,,,,,,,
7,7,,,,,,,,,,,
0,0,0,0,0,0,0,0,0,0,0,0,0
0,0,0,0,0,0,0,0,0,0,0,0,0
0,0,0,0,1,1,1,1,1,0,0,0,0
1,0,0,0,1,0,0,0,1,0,0,0,1
1,1,1,1,1,0,3,0,1,1,1,1,1
1,0,0,0,1,0,0,0,1,0,0,0,1
1,0,0,0,1,1,1,1,1,0,0,0,1
1,0,0,0,0,0,0,0,0,0,0,0,1
1,0,0,0,0,0,0,0,0,0,0,0,1
1,0,0,0,0,0,0,0,0,0,0,0,1
1,0,0,0,0,0,0,0,0,0,0,0,1
1,0,0,0,0,0,0,0,0,0,0,0,1
1,0,0,0,0,0,0,0,0,0,0,0,1
