6,9,,,,,,,
7,20,,,,,,,
4,5,,,,,,,
0,0,0,0,0,0,0,0,0
0,0,0,0,0,0,0,0,0
1,1,1,1,1,1,1,1,1
1,1,1,1,1,1,1,1,1
0,0,0,0,0,0,0,0,0
1,0,0,0,3,0,0,0,1
