7,11,,,,,,,,,
10,7,,,,,,,,,
4,6,,,,,,,,,
1,1,1,1,1,1,1,1,1,1,1
1,0,0,0,0,0,0,0,0,0,1
1,0,0,0,0,0,0,0,0,0,1
1,0,0,0,0,0,0,0,0,0,1
1,0,0,1,1,1,1,1,0,0,1
1,0,0,1,0,0,0,1,0,0,1
1,1,1,1,0,3,0,1,1,1,1
