7,9
5,23
4,5
0,0,0,0,0,0,0,0,0
0,0,0,0,0,0,0,0,0
0,0,0,0,0,1,1,1,1
0,0,0,0,0,0,0,0,0
0,0,0,0,0,0,0,0,3
1,1,1,1,1,1,1,1,1
1,1,1,1,1,1,1,1,1
