5,13,,,,,,,,,,,
5,8,,,,,,,,,,,
3,7,,,,,,,,,,,
0,1,1,1,1,0,0,0,1,1,1,1,0
0,0,0,0,0,0,0,0,0,0,0,0,0
0,0,0,0,0,0,0,0,0,0,0,0,0
1,1,1,1,1,1,1,1,1,1,1,1,1
0,0,0,0,0,0,0,0,0,0,0,0,0
